estandar	dialectal	whisper
|T12|	|T12|	en
encuentra	encuentra	respecto
respecto	respecto	a
la	la	la
educación	educación	educación
de	de	de
los	los	los
niños	niños	niños
~,	~,	antes
antes	antes	y
y	y	ahora
ahora	ahora	hombre,
~?	~?	y
[HS:I1	[HS:I1	él
		Hombre			Hombre	le
~.	~.	diga
		]			]	las
Que	Que	perspectivas
~…	~…	de
Y	Y
las	las
perspectivas	perspectivas
que	que
[HS:I1	[HS:I1
		Ahora			Ahora
~…	~…
		]			]
tienen	tienen
~…	~…
