estandar	dialectal	whisper
aquí	aquí	que
adonde	ande	acá
yo	yo	no
he	he	yo
estao	estao	tengoベts
~,	~,	los
son	son	Agorais
ocho	ocho	y
hijos	hijos	de
~.	~.	todo
Están	Están
como	como
[A-Inn]	[A-Inn]
~,	~,
trabajadores	trabajadores
y	y
de	de
to	to
a	a
to	to
~.	~.
Pues	Pues
el	el
día	día
que	que
falte	falte
el	el
padre	padre
~…	~…
~,	~,
~¡~	~¡~
ya	ya
verás	verás
~!	~!
[R-Prt]	[R-Prt]
