estandar	dialectal	whisper
[A-Inn]	[A-Inn]	¿Qué
Ella	Ella	es
es	es	eso?
quien	quien	¿Qué
los	los	es
pinta	pinta	eso?
~.	~.	¿Qué
[HS:E2	[HS:E2	es
		Ah			Ah	eso?
~,	~,	¿Qué
los	los	es
pintan	pintan
~.	~.
		]			]
[HS:E1	[HS:E1
		Es			Es
lo	lo
que	que
iba	iba
a	a
preguntar	preguntar
~.	~.
		]			]
[A-PIn:	[A-PIn:
		Tienen			Tienen
		]			]
unas	unas
navajicas	navajicas
~…	~…
