estandar	dialectal	whisper
[Asent]	[Asent]	Y
~.	~.	aquí
¿~	¿~	a
Y	Y	tres
~…	~…	papavasesome
aquí	aquí	muy
aves	aves	preusos,
rapaces	rapaces	hábicado,
águilas	águilas	cáncer,
o	o	Raree
~…	~…	Bundesle
[TOS]	[TOS]	mettí
buitres	buitres	un
o	o	gran
~…	~…	Oil.iver
ha	ha
habido	habido
casos	casos
en	en
que	que
se	se
han	han
llevado	llevado
a	a
una	una
oveja	oveja
o	o
~…	~…
~?	~?
