estandar	dialectal	whisper
[A-Inn]	[A-Inn]	Me
Me	Me	levantaba
levantaba	levantaba	y
y	y	me
iba	iba	meté
adonde	ande	en
tenía	tenía	aquella.
que	que	No
ir	ir	me
~.	~.	gustaba
[R-Anm]	[R-Anm]	molestar
[PS]	[PS]	la
[HS:E1	[HS:E1	camibo.
		Pues			Pues	Y
~…	~…	cuando
		]			]	digo
No	No	que
me	me	estaba
gustaba	gustaba	sabatillo,
molestarlas	molestarlas	me
tampoco	tampoco	maté
~.	~.	como
Y	Y	el
cuando	cuando	L
digo	digo	partnerediva
~:	~:	con
«~	«~	Luis
Uy	Uy
~,	~,
estos	estos
zapatillos	zapatillos
tan	tan
bonicos	bonicos
me	me
los	los
llevo	llevo
yo	yo
a	a
mi	mi
casa	casa
~»	~»
~.	~.
[RISA]	[RISA]
