estandar	dialectal	whisper
Mire	Mire	pero
usted	usted	se
que	que	que
llevamos	llevamos	llevamos
preguntando	preguntando	preguntando
por	por	con
la	la	la
matanza	matanza	matanza
ni	ni	ni
le	le	de
digo	digo	divertimiento
el	el	y
tiempo	tiempo	instrumental
y	y	no
instrumental	instrumental	que
[Rndo:	[Rndo:	ha
		no			no	movido
habíamos	habíamos	sin
[HS:E3	[HS:E3
		No			No
~,	~,
no	no
~,	~,
no	no
~.	~.
		]			]
visto	visto
todavía	todavía
~.	~.
		]			]
