estandar	dialectal	whisper
Un	Un	La
día	día	mayoría
tenemos	tenemos	tenemos
que	que	que
venir	venir	venir
a	a	a
entrevistarla	entrevistarla	entrevistarla
para	para	para
que	que	que
nos	nos	nos
dé	dé	de
una	una	una
~,	~,	recetas,
unas	unas	a
recetas	recetas	las
~.	~.	que
Haga	Haga	los
usted	usted	libros
un	un	de
libro	libro	recetas
de	de	consumienta.
recetas	recetas	La
con	con	tiene
su	su
nieta	nieta
~.	~.
¿~	¿~
Lo	Lo
tiene	tiene
hecho	hecho
~?	~?
[HS:I1	[HS:I1
		No			No
~,	~,
		]			]
