estandar	dialectal	whisper
[A-Pau:	[A-Pau:	Olive
		Pues			Pues	oil
~…	~…	por
no	no	solo
lo	lo	así.
sé	sé	No.
~.	~.	Havasro
		]			]	ver
[HS:E1	[HS:E1	más
		¿~			¿~	coarse
No	No	cannotas.
~?	~?	En
		]			]	este
[A-Nul]	[A-Nul]	momento
aquí	aquí	hay
en	en	puliros
todo	todo	morales
el	el	verdes
concejo	concejo
de	de
Candamo	Candamo
había	había
cinco	cinco
o	o
hay	hay
~…	~…
once	once
parroquias	parroquias
~.	~.
[R-Ind]	[R-Ind]
