estandar	dialectal	whisper
Bueno	Bueno	Y
~,	~,	nos
jugábamos	jugábamos	vamos
a	a	a
todo	todo	todo
~:	~:	pelota
a	a	a
pelota	pelota	las
~,	~,	convite
al	al	para
escondite	escondite	que
por	por	el
aquí	aquí	pueblo,
el	el	que
pueblo	pueblo	juegos
~;	~;	de
juegos	juegos	esos
de	de	los
esos	esos	siempre
~,	~,	también,
los	los	ahí
de	de	hemos
siempre	siempre	lo
también	también
~,	~,
sí	sí
~,	~,
más	más
o	o
menos	menos
~.	~.
