estandar	dialectal	whisper
Y	Y	Y
el	el	el
colchón	colchón	coche
había	había	no
que	que	había
hacerle	hacerle	que
unos	unos	hacerle
cuidados	cuidados	unos
especiales	especiales	cuidados
~,	~,	especiales,
¿~	¿~	¿no?
no	no	Una
~?	~?	vez
Un	Un	al
~,	~,	año.
o	o	No
una	una	sólo
vez	vez	dé
al	al	soy工作
año	año	сыとか
~,	~,	soy
dos	dos	con
veces	veces	el
al	al	mismostudio,
año	año	de
~.	~.	calcium,
[HS:I1	[HS:I1	en
		Sí			Sí	приз
~,	~,	de
se	se	had
ha-	ha-
~,	~,
		]			]
