estandar	dialectal	whisper
|T16|	|T16|	y
¿~	¿~	aquí
Y	Y	a
aquí	aquí	las
a	a	mujeres
las	las	antes
mujeres	mujeres	como
antes	antes	era
~,	~,	eso
cómo	cómo	de
era	era	los
eso	eso	partos
de	de	y
los	los	eso
partos	partos	venía
~?	~?	a
Y	Y	ser
[HS:I2	[HS:I2	justo
		Eso			Eso	de
~,	~,	los
pregúntalo	pregúntalo
aquí	aquí
~.	~.
		]			]
[V-Sml]	[V-Sml]
¿~	¿~
venía	venía
el	el
médico	médico
~?	~?
