estandar	dialectal	whisper
Al	Al	El
partido	partido	partido
~,	~,	que
que	que	le
le	le	llamaba
llamábamos	llamábamos	la
~,	~,	Cámara
que	que	de
nos	nos	Juegos.
juntábamos	juntábamos	Sí,
dos	dos	sí,
~…	~…
[HS:E3	[HS:E3
		Yo			Yo
a	a
la	la
comba	comba
también	también
he	he
jugao	jugao
~.	~.
Claro	Claro
~.	~.
		]			]
¿~	¿~
Eh	Eh
~?	~?
Sí	Sí
~,	~,
también	también
jugabas	jugabas
~.	~.
