estandar	dialectal	whisper
[Asent]	[Asent]	pero
~.	~.	que
Pero	Pero	habitatal
que	que	puppy
formal	formal	pues...
hasta	hasta	O
los	los	valía,¿no
catorce	catorce	lo
o	o	avería
quince	quince	por
años	años	lo
~,	~,
pues	pues
no	no
lo	lo
veríamos	veríamos
los	los
zapatos	zapatos
~.	~.
[R-Mcr]	[R-Mcr]
