estandar	dialectal	whisper
Yo	Yo	para
pa	pa	los
los	los	niños,
niños	niños	hombre,
~…	~…	que
~,	~,	hay
hombre	hombre	un
~,	~,	mes,
si	si	es
cae	cae	muy
uno	uno	eso,
enfermo	enfermo	pero
y	y	sí,
eso	eso	antes.
[HS:E1	[HS:E1	Ahora
		Sí			Sí	no
~.	~.	hará
		]			]	que
~,	~,	bajar
pues	pues	el
sí	sí
~,	~,
antes	antes
~,	~,
ahora	ahora
no	no
~,	~,
ahora	ahora
hay	hay
que	que
bajar	bajar
a	a
Sigüenza	Sigüenza
~.	~.
