estandar	dialectal	whisper
Bueno	Bueno	Bueno,
~,	~,	pues
pues	pues	primero
primero	primero	mi
~|	~|	mujer
mi	mi	no
mujer	mujer	le
no	no	gusta
le	le	a
gusta	gusta	otros
~.	~.	cazadores,
A	A	lo
lo	lo	sabían
mejor	mejor	y
a	a	luego
otros	otros	van
cazadores	cazadores	al
los	los	veterinario
avían	avían	bh
~,	~,
y	y
luego	luego
van	van
al	al
veterinario	veterinario
a	a
que	que
los	los
miren	miren
~,	~,
a	a
ver	ver
si	si
están	están
bien	bien
o	o
mal	mal
~.	~.
