estandar	dialectal	whisper
Pues	Pues	Pues
antes	antes	antes
había	había	había
unas	unas	unas
máquinas	máquinas	máquinas
que	que	que
eran	eran	era
~,	~,	como
como	como	si
si	si	diría
dijéramos	dijéramos	que
~,	~,	era
mal	mal	muy
comparao	comparao	incomparable
~,	~,	y
un	un	yo
molinillo	molinillo	gande,
grande	grande	que
~,	~,	era
que	que	la
dabas	dabas	que
a	a	era
la	la	la
vuelta	vuelta	vuelta
~,	~,	y
iban	iban	un
echando	echando	echando
el	el	el
trigo	trigo
~.	~.
