estandar	dialectal	whisper
Sí	Sí	Sí,
~,	~,	así
si	si	bien
veían	veían	la
la	la	cosa
cosa	cosa	mal,
mal	mal	llamaba
~…	~…	en
~,	~,	el
llamaban	llamaban	médico
al	al	cabellera,
médico	medíco	pero
cabecera	cabecera	sí,
~.	~.	el
Pero	Pero	partido
si	si	había,
el	el	pues
parto	parto	bien,
iba	iba	no
bien	bien	pasa
~…	~…
~,	~,
pues	pues
bien	bien
~,	~,
no	no
pasaba	pasaba
nada	nada
~.	~.
