estandar	dialectal	whisper
[HCruz:	[HCruz:	¿Qué?
		Pues			Pues	Para
mire	mire	mí
~,	~,	le
enseñándoles	enseñándoles	es,
la	la	y
bodega	bodega	le
~,	~,	da
[RISAS]	[RISAS]	nuestra
ahora	ahora	nueva.
les	les	Ahora
explica	explica	les
usted	usted	explico
cómo	cómo	usted
se	se	como
hacía	hacía	se
el	el	hacía
vino	vino	el
~,	~,	vino,
la	la	la
remanga	remanga	remarga
y	y	y
cómo	cómo	cómo
eran	eran	deralas
las	las	cosas.
cosas	cosas	EsaTC
~.	~.	de
 	 	talaba
 	 	que
 	 	GTA.
