estandar	dialectal	whisper
Mira	Mira	Mira,
~,	~,	¡Es
el	el	este
del	del	¡susanan
hijo	hijo	body
con	con	no
siete	siete	es
años	años	cierto!
está	está	y
~,	~,	por
ha	ha	qué
terminao	terminao	todos
la	la	los
carrera	carrera	días
también	también	estamos
~;	~;	mình
la	la	para
otra	otra	Rudi部分
derecho	derecho	berし
~.	~.	paul
[HS:E2	[HS:E2	tene
		¿~			¿~	woah
Son	Son	pouvez
ustedes	ustedes	ver
~?	~?	jot
 	 	c
 	 	dou
 	 	nen
 	 	indiano
 	 	c
