estandar	dialectal	whisper
Pues	Pues	Nos
cortaban	cortaban	cortaban
la	la	la
leña	leña	noche,
~,	~,	si
[HS:E2	[HS:E2	se
		Sí			Sí	pinta
~.	~.	de
		]			]	todos
se	se	los
picaba	picaba	grandes.
en	en	Así,
trozos	trozos	la
grandes	grandes	cianornos
~,	~,	lo
así	así	tapaba
~,	~,	con
y	y	tu
hacían	hacían	coyerba,
hornos	hornos	el
~,	~,
lo	lo
tapaban	tapaban
con	con
un	un
poco	poco
hierba	hierba
~,	~,
con	con
~…	~…
