estandar	dialectal	whisper
Dos	Dos	los
horas	horas	horas
o	o	o
cuatro	cuatro	cuatro
hasta	hasta	hasta
que	que	que
se	se	se
soltaba	soltaba	soldaba
~,	~,	porque
porque	porque	ese
ese	ese	hermiente
hormiento	hormiento	que
que	que	le
le	le	echábamos
echábamos	echábamos	ese
era	era	charges
el	el	total
que	que	remember
hacía	hacía	violentamente
soltar	soltar
~,	~,
hacía	hacía
crecer	crecer
el	el
pan	pan
~.	~.
