estandar	dialectal	whisper
Sí	Sí	Si,
~,	~,	de
nada	nada	verdad,
~,	~,	veremos
ya	ya	si
veremos	veremos	a
~.	~.	mejor
Si	Si	estamos
a	a	haciendo
lo	lo	todas
mejor	mejor	las
~…	~…
[HS:E2	[HS:E2
		Nos			Nos
han	han
dado	dado
aquí	aquí
el	el
nombre	nombre
de	de
	
Anonimizado	Anonimizado
	
~.	~.
		]			]
Estamos	Estamos
haciendo	haciendo
toda	toda
la	la
zona	zona
también	también
~.	~.
