estandar	dialectal	whisper
Bueno	Bueno	Bueno,
~,	~,	tiene
		un
Anonimizado	Anonimizado	largo
		la
tiene	tiene	llegue
un	un	a
árbol	árbol	su
allí	allí	casa
en	en	y
su	su	cogemos
casa	casa	algunas.
y	y	No
cogemos	cogemos	la
alguna	alguna	verdad.
~,	~,	Y
[HS:E2	[HS:E2	para
		[Asent]			[Asent]	eso
~.	~.	la
		]			]	utilizamos
y	y	y
nos	nos
las	las
da	da
~.	~.
Y	Y
para	para
eso	eso
la	la
utilizamos	utilizamos
~,	~,
si	si
no	no
~,	~,
pues	pues
nada	nada
~.	~.
