estandar	dialectal	whisper
Sí	Sí	No,
~,	~,	señor,
no	no	la
~,	~,	mayor
si	si	parte
yo	yo	de
la	la	mi
mayor	mayor	vida
parte	parte	es
de	de	el
mi	mi	pastor,
vida	vida	no?
he	he	Sí.
sido	sido	Juan
pastor	pastor	M
~.	~.	Sai
¿~	¿~
Entiendes	Entiendes
~?	~?
[HS:E	[HS:E
		Sí			Sí
~.	~.
		]			]
Y	Y
~…	~…
y	y
ya	ya
digo	digo
~…	~…
