estandar	dialectal	whisper
¿~	¿~
Qué	Qué
te	te
voy	voy
a	a
decir	decir
~?	~?
Mira	Mira
como	como
si	si
[HS:I2	[HS:I2
		Que			Que
~…	~…
la	la
conoces	conoces
más	más
bien	bien
		]			]
[A-Inn]	[A-Inn]
esta	esta
mujer	mujer
porque	porque
tiene	tiene
el	el
pelo	pelo
más	más
negro	negro
que	que
la	la
otra	otra
~…	~…
