estandar	dialectal	whisper
¿~	¿~	yo
Y	Y	todo
todo	todo	obwohlas
eso	eso	pi
ha	ha	Η
escrito	escrito
esta	esta
moceta	moceta
desde	desde
que	que
está	está
aquí	aquí
~?	~?
[RISAS]	[RISAS]
Imagino	Imagino
que	que
te	te
van	van
nada	nada
~.	~.
