estandar	dialectal	whisper
Pues	Pues	Pues
cordón	cordón	por
umbilical	umbilical	lo
~.	~.	lic娘.
[RISAS]	[RISAS]	Ya
Claro	Claro	tienes
~.	~.	bastante
[SLNC]	[SLNC]	tema
¿~	¿~	o
Ya	Ya	no?
tenéis	tenéis	No?
bastante	bastante	Aún
tema	tema	faltaakter
o	o	por
no	no	el
~?	~?	ED.interromersar
¿~	¿~	mi
Aún	Aún	valle
falta	falta	no
algo	algo	hay
~?	~?	la
Hala	Hala	mesa.
~,	~,	Lo
que	que	tengo
me	me	con
tengo	tengo
que	que
ir	ir
yo	yo
~.	~.
Tengo	Tengo
que	que
~|	~|
está	está
mi	mi
marido	marido
ahí	ahí
en	en
la	la
mesa	mesa
~.	~.
Lo	Lo
tengo	tengo
con	con
alzhéimer	alzhéimer
~.	~.
