estandar	dialectal	whisper
Leche	Leche	ắ
frita	frita	penetradas,
~.	~.	de
¿~	¿~	INF
Cómo	Cómo	Humanit
que	que	no
no	no	se
~?	~?	Джospitan,
No	No	lo
la	la	que
hacéis	hacéis	hicieron
o	o	porque
qué	qué	quadras
~.	~.	sonQué
[V-Ljn]	[V-Ljn]	difícil,
Claro	Claro	un
~.	~.	sal恥
Di	Di	y
que	que	personas
todavía	todavía	fritos
lo	lo	quien
hacen	hacen	se
en	en	los
casa	casa	Lower
~.	~.	otro.
Orejones	Orejones	Pues
~,	~,	les
rosquillitas	rosquillitas	te
~,	~,
leche	leche
frita	frita
~…	~…
