estandar	dialectal	whisper
Pues	Pues	Pues,
~…	~…	haciendo
eso	eso	viento
haciendo	haciendo	con
viento	viento	un
~,	~,	aparato
con	con	de
un	un	viento
aparato	aparato	que
de	de	llamamos,
~…	~…	lo
bieldo	bieldo	tigamos
[HS:I2	[HS:I2	al
		Con			Con	aire
un	un	y
aparato	aparato	hay
~.	~.	que
		]			]	el
que	que	tigo
llamábamos	llamábamos	y
~.	~.	la
Lo	Lo	paja
tiras	tiras	más
al	al
aire	aire
y	y
ahí	ahí
cae	cae
el	el
trigo	trigo
~,	~,
y	y
la	la
paja	paja
marcha	marcha
pa	pa
allí	allí
~.	~.
