estandar	dialectal	whisper
Más	Más	Más
miedo	miedo	miedo,
~,	~,	no.
no	no	Y
~.	~.	bien
Y	Y	miedo,
bien	bien	eso
miedo	miedo	para
~,	~,	todas.
eso	eso	Dos
pa	pa	años
todas	todas	ha
~.	~.	hecho
Dos	Dos	que
años	años	teníamos
ha	ha	un
hecho	hecho	pastor
que	que	y
teníamos	teníamos	no
un	un	lo
pastor	pastor	mató,
y	y	¿no?
nos	nos	Así
lo	lo	que
mató	mató	miras
una	una	y
chispa	chispa	vamos
~.	~.
Así	Así
que	que
mira	mira
si	si
vamos	vamos
por	por
miedos	miedos
~.	~.
