estandar	dialectal	whisper
¿~	¿~
Sabes	Sabes
~?	~?
La	La
rabiosa	rabiosa
es	es
más	más
mala	mala
y	y
además	además
es	es
mu	mu
peligrosa	peligrosa
porque	porque
anda	anda
en	en
todas	todas
las	las
carnes	carnes
muertas	muertas
~,	~,
la	la
rabiosa	rabiosa
~,	~,
se	se
muere	muere
un	un
bicho	bicho
~,	~,
donde	donde
se	se
muera	muera
~,	~,
allá	allá
que	que
va	va
~.	~.
