estandar	dialectal	whisper
Malas	Malas	Te
personas	personas	muerrealmente,
~.	~.	solo
[RISAS]	[RISAS]	creus
No	No	compensateenme
son	son	buena
como	como	una
tienen	tienen	agenda
que	que	mas
ser	ser	interval
de	de	de
buenas	buenas	para
[HS:E	[HS:E
		¿~			¿~
Y	Y
qué	qué
~…	~…
~?	~?
		]			]
que	que
no	no
te	te
pongan	pongan
la	la
mano	mano
en	en
el	el
hombro	hombro
~,	~,
tonta	tonta
~.	~.
