estandar	dialectal	whisper
Antes	Antes	Antes,
~,	~,	cochinó
el	el	como
cochino	cochino	los
~,	~,	juguillos
como	como	no
lo	lo	me
coges	coges	lo
y	y	mataba,
lo	lo	suponía
matabas	matabas	sopas
~,	~,	cortadas.
[HS:E	[HS:E	No
		[Asent]			[Asent]	lo
~.	~.	la
		]			]	f
ponías	ponías	diaryera,
		con
sopas	sopas	las
		]			]	fors
cortadas	cortadas	que
~,	~,	rigidas
la	la	son
otra	otra
noche	noche
se	se
cortaban	cortaban
las	las
sopas	sopas
~.	~.
