estandar	dialectal	whisper
No	No	No,
pero	pero	pero
es	es	es
muy	muy	muy
bo-	bo-	gruesa.
~,	~,	Me
o	o	encanta
sea	sea	cuando
me	me	voy
encanta	encanta	a
cuando	cuando	ir
voy	voy	a
siempre	siempre	Fitaleta,
a	a	a
Hospitalet	Hospitalet	la
~,	~,	vuelta,
damos	damos	vamos
una	una	a
vuelta	vuelta	ir
~,	~,	a
[HS:I1	[HS:I1	Barcelona,
		Sí			Sí	siempre
~.	~.
		]			]
vamos	vamos
a	a
Barcelona	Barcelona
~.	~.
Siempre	Siempre
visitamos	visitamos
~.	~.
