estandar	dialectal	whisper
Aquí	Aquí	Aquí
~,	~,	como母ira
aquí	aquí	típica,
~…	~…	que
la	la	piques
comida	comida	que
típica	típica	te
~…	~…	diga,
Qué	Qué	sea
quieres	quieres	como...
que	que	O,
te	te	ahora
diga	diga	comfy
~,	~,	esta
se	se	más
come	come	inac
de	de	Screen氣...
todo	todo	La
~,	~,
[HS:E1	[HS:E1
		[Asent]			[Asent]
~.	~.
		]			]
¿~	¿~
eh	eh
~?	~?
Como	Como
ahora	ahora
~,	~,
en	en
fiesta	fiesta
~,	~,
más	más
que	que
nada	nada
~,	~,
la	la
paella	paella
~.	~.
