estandar	dialectal	whisper
Uy	Uy	Su
~,	~,	sí,
eso	eso	siempre.
sí	sí	Y
~.	~.	al
[HS:I2	[HS:I2	minumato
		Eso			Eso	con...
siempre	siempre	Bueno,
~.	~.	yo
		]			]	lo
A	A	viví
mí	mí	porque
no	no	mi
me	me	nacido,
ha	ha	nací
tocado	tocado	tortosa
~.	~.	en
Bueno	Bueno	la
~,	~,	llana,
yo	yo	pero
lo	lo	pasa
viví	viví	de
porque	porque	un
mi	mi	gran
hija	hija	tomado,
nació	nació	¿eh?
~,	~,	Me
nació	nació	selecto
en	en	había
Tortosa	Tortosa
~,	~,
allá	allá
en	en
la	la
clínica	clínica
~,	~,
pero	pero
pasé	pasé
un	un
rato	rato
mal	mal
~,	~,
¿~	¿~
eh	eh
~?	~?
[HS:I2	[HS:I2
		Claro			Claro
~.	~.
		]			]
Cago	Cago
en	en
diez	diez
~…	~…
