estandar	dialectal	whisper
|T12|	|T12|	No
No	No	sé,
sé	sé	el
~,	~,	tema
el	el	que
tema	tema	no
que	que	se
nos	nos	ha
ha	ha	dejado
dejado	dejado	así
así	así	a
a	a	media,
medias	medias	ser
~.	~.	el
El	El	profesor
~,	~,	antes,
el	el	tenía
profesor	profesor	mucha
antes	antes	autoridad,
~,	~,	se
¿~	¿~	le
tenía	tenía	tenía
mucha	mucha	miedo
autoridad	autoridad	a
~?	~?	usted,
¿~	¿~	al
Se	Se
le	le
~…	~…
~?	~?
¿~	¿~
Le	Le
tenía	tenía
miedo	miedo
usted	usted
~,	~,
al	al
profe	profe
~?	~?
