estandar	dialectal	whisper
Como	Como	Vamos
van	van	a
a	a	volver
volver	volver	a
a	a	meter
meter	meter	los
los	los	centimos.
céntimos	céntimos	Sí,
[HS:I1	[HS:I1	nos
		Sí			Sí	vamos
~.	~.	a
		]			]	meter.
pues	pues	No,
en	en	no,
el	el	no,
momento	momento
que	que
~…	~…
[HS:I4	[HS:I4
		Este			Este
también	también
es	es
mu	mu
bueno	bueno
[A-Inn]	[A-Inn]
		]			]
noventa	noventa
céntimos	céntimos
nada	nada
~.	~.
[RISAS]	[RISAS]
