estandar	dialectal	whisper
[Asent]	[Asent]	Y
~.	~.	no
¿~	¿~	hay
Y	Y	nada
no	no	que
hay	hay	ver
nada	nada	acá
que	que	en
vea	vea	sus
que	que	minetas
hacen	hacen	y
sus	sus	que
nietas	nietas	usted
y	y	le
que	que	hubiera
[HS:I1	[HS:I1	gustado
		Ah			Ah
~,	~,
¿~	¿~
yo	yo
~?	~?
		]			]
a	a
usted	usted
le	le
hubiera	hubiera
gustado	gustado
hacer	hacer
cuando	cuando
era	era
joven	joven
~?	~?
