estandar	dialectal	whisper
La	La	Ruto
ruta	ruta	Pakao
del	del	empezó
bacalao	bacalao	aquí
empezó	empezó	en
aquí	aquí	Valencia,
en	en	que
Valencia	Valencia	es
que	que	donde
es	es	se
donde	donde	menaba
se	se	todo
meneaba	meneaba	el
todo	todo	dinero.
el	el	Este
dinero	dinero	cabrón
~.	~.	no
[R-Inf]	[R-Inf]	había
Claro	Claro	forma
~,	~,	de
y	y	hacer
se	se	un
extendió	extendió
pa	pa
la	la
costa	costa
~.	~.
Y	Y
este	este
cabrón	cabrón
~,	~,
este	este
no	no
había	había
forma	forma
de	de
hacerlo	hacerlo
trabajar	trabajar
~.	~.
