estandar	dialectal	whisper
Claro	Claro	que
~,	~,	a
se	se	los
escribían	escribían	espirian
cartas	cartas	cartas
~,	~,	les
les	les	mandaban
mandaban	mandaban	a
a	a	lo
lo	lo	mejor
mejor	mejor	poesillas
poesías	poesías	un
~,	~,	día
o	o	señalar
~…	~…	la
[HS:E1	[HS:E1	onda
		Ah			Ah	mandaba
~…	~…	flores
		]			]	esas
un	un	cosas
día	día
señalao	señalao
la	la
~…	~…
mandaba	mandaba
flores	flores
~,	~,
o	o
esas	esas
cosas	cosas
como	como
~…	~…
