estandar	dialectal	whisper
Pues	Pues	No,
nada	nada	no
~,	~,	se
¿~	¿~	acuerda
no	no	del
se	se	con
acuerda	acuerda	cuenta
de	de	de
algún	algún	cuando
cuento	cuento	le
de	de	contara
cuan-	cuan-	su
~,	~,	abuela
que	que	cuando
le	le	era
contara	contara
su	su
abuela	abuela
cuando	cuando
era	era
pequeña	pequeña
o	o
~…	~…
~?	~?
¿~	¿~
No	No
~?	~?
[RISAS]	[RISAS]
Bueno	Bueno
~,	~,
pues	pues
~…	~…
