estandar	dialectal	whisper
nunca	nunca	nunca
a	a	los
los	los	chávales
chavales	chavales	o
a	a	la
la	la	he
ikastola	ikastola	castóla.
~,	~,	¿Crees
¿~	¿~	por
eh	eh	qué?
~?	~?	Porque
¿~	¿~	me
Sabes	Sabes	parecía
por	por	que
qué	qué	politina
~?	~?	y
Porque	Porque	me
me	me	daban
parecía	parecía	tanto
que	que	asco,
politizaban	politizaban	no
todo	todo	lo
y	y	se
me	me
daban	daban
tanto	tanto
asco	asco
~,	~,
no	no
les	les
he	he
mandao	mandao
~.	~.
