estandar	dialectal	whisper
Bien	Bien	Bien,
~.	~.	entonces,
Entonces	Entonces	tú
tú	tú	imagínate
imagínate	imagínate	que
que	que	este
este	este	hombre
hombre	hombre	en
en	en	lugar
lugar	lugar	de
de	de	ser
ser	ser	un
religioso	religioso	religioso
eh	eh	hubiese
~…	~…	sido
hubiese	hubiese	alcalde
sido	sido	¿Qué
alcalde	alcalde	cosa
¿~	¿~	habría
qué	qué	hecho
cosas	cosas	él?
habría	habría	¿Qué
hecho	hecho	otros
él	él
que	que
otros	otros
no	no
~…	~…
~?	~?
