estandar	dialectal	whisper
Sí	Sí	fuimos
~.	~.	aquí
Fuimos	Fuimos	una
allí	allí	y
a	a	hacemos
una	una	yo
~…	~…	a
~,	~,	que
ya	ya	lo
se	se	merei
murió	murió	pero
aquel	aquel	las
hombre	hombre	mujeres
~,	~,	ya
te	te	estuvo
digo	digo	que
~.	~.	trabajaban
Pero	Pero
las	las
mujeres	mujeres
~,	~,
¿~	¿~
sabes	sabes
tú	tú
lo	lo
que	que
trabajaban	trabajaban
aquí	aquí
~?	~?
