estandar	dialectal	whisper
En	En	en
los	los	los
pinos	pinos	pinos.
~,	~,	Sí.
[HS:I1	[HS:I1	Y
		Sí			Sí	luego
~.	~.	lo
		]			]	que
muy	muy	decía
bien	bien	usted
~.	~.	cuando
Y	Y	salían
luego	luego	los
~,	~,	niños
lo	lo	del
que	que	colegio,
decía	decía	se
usted	usted	van
~,	~,	a
cuando	cuando
salían	salían
los	los
niños	niños
del	del
colegio	colegio
~,	~,
¿~	¿~
se	se
iban	iban
a	a
jugar	jugar
~?	~?
