estandar	dialectal	whisper
pues	pues	El
entonces	entonces	palecito
~,	~,	es
[HS:I2	[HS:I2	hecho
		¿~			¿~	de
Está	Está	mi
bueno	bueno	mujer,
~?	~?	ahora
		]			]	no
[HS:E2	[HS:E2	ha
		Muy			Muy	tenido,
bueno	bueno	porque
~.	~.	ya
		]			]	se
el	el	unas
panecito	panecito	barras
es	es	así
hecho	hecho	grandes
de	de	y
mi	mi	después
mujer	mujer	las
~.	~.	partes
Ahora	Ahora	nos
no	no	ponen
ha	ha	la
tenido	tenido	conservadora
~,	~,	y
porque	porque	cada
hace	hace	día
unas	unas	tenemos
barras	barras	de
así	así	opán
grandes	grandes
~,	~,
eh	eh
~,	~,
y	y
después	después
las	las
parte	parte
~,	~,
los	los
pone	pone
en	en
la	la
conservadora	conservadora
[HS:I2	[HS:I2
		[A-Inn]			[A-Inn]
~.	~.
		]			]
y	y
cada	cada
día	día
tuvi-	tuvi-
~,	~,
tenemos	tenemos
el	el
pan	pan
[OTRAS-EM]	[OTRAS-EM]
fresco	fresco
~.	~.
